state: estado de EE. UU. (por número) - no se cuenta como predictivo arriba, pero si se considera, debe considerarse nominal (nominal) 
county: código numérico del condado - no predictivo, y muchos valores faltantes (numérico) 
community: código numérico de la comunidad - no predictivo y muchos valores faltantes (numérico) 
communityname: nombre de la comunidad - no predictivo - solo para información (cadena) 
fold: número de pliegue para validación cruzada de 10 pliegues no aleatoria, potencialmente útil para depurar, pruebas emparejadas - no predictivo (numérico) 
population: población de la comunidad: (numérico - decimal) 
householdsize: promedio de personas por hogar (numérico - decimal) 
racepctblack: porcentaje de población afroamericana (numérico - decimal) 
racePctWhite: porcentaje de población caucásica (numérico - decimal) 
racePctAsian: porcentaje de población de ascendencia asiática (numérico - decimal) 
racePctHisp: porcentaje de población de ascendencia hispana (numérico - decimal) 
agePct12t21: porcentaje de población de 12 a 21 años (numérico - decimal) 
agePct12t29: porcentaje de población de 12 a 29 años (numérico - decimal) 
agePct16t24: porcentaje de población de 16 a 24 años (numérico - decimal) 
agePct65up: porcentaje de población de 65 años y más (numérico - decimal) 
numbUrban: número de personas que viven en áreas clasificadas como urbanas (numérico - decimal) 
pctUrban: porcentaje de personas que viven en áreas clasificadas como urbanas (numérico - decimal) 
medIncome: ingreso familiar mediano (numérico - decimal) 
pctWWage: porcentaje de hogares con ingresos de salario o sueldo en 1989 (numérico - decimal) 
pctWFarmSelf: porcentaje de hogares con ingresos agrícolas o por cuenta propia en 1989 (numérico - decimal) 
pctWInvInc: porcentaje de hogares con ingresos de inversión/alquiler en 1989 (numérico - decimal) 
pctWSocSec: porcentaje de hogares con ingresos de seguridad social en 1989 (numérico - decimal) 
pctWPubAsst: porcentaje de hogares con ingresos de asistencia pública en 1989 (numérico - decimal) 
pctWRetire: porcentaje de hogares con ingresos de jubilación en 1989 (numérico - decimal) 
medFamInc: ingreso familiar mediano (difiere del ingreso del hogar para hogares no familiares) (numérico - decimal) 
perCapInc: ingreso per cápita (numérico - decimal) 
whitePerCap: ingreso per cápita para caucásicos (numérico - decimal) 
blackPerCap: ingreso per cápita para afroamericanos (numérico - decimal) 
indianPerCap: ingreso per cápita para nativos americanos (numérico - decimal) 
AsianPerCap: ingreso per cápita para personas de ascendencia asiática (numérico - decimal) 
OtherPerCap: ingreso per cápita para personas de 'otra' herencia (numérico - decimal) 
HispPerCap: ingreso per cápita para personas de ascendencia hispana (numérico - decimal) 
NumUnderPov: número de personas por debajo del nivel de pobreza (numérico - decimal) 
PctPopUnderPov: porcentaje de personas por debajo del nivel de pobreza (numérico - decimal) 
PctLess9thGrade: porcentaje de personas de 25 años o más con menos de noveno grado de educación (numérico - decimal) 
PctNotHSGrad: porcentaje de personas de 25 años o más que no son graduadas de la escuela secundaria (numérico - decimal) 
PctBSorMore: porcentaje de personas de 25 años o más con una licenciatura o educación superior (numérico - decimal) 
PctUnemployed: porcentaje de personas de 16 años o más, en la fuerza laboral, y desempleadas (numérico - decimal) 
PctEmploy: porcentaje de personas de 16 años o más que están empleadas (numérico - decimal) 
PctEmplManu: porcentaje de personas de 16 años o más que están empleadas en la manufactura (numérico - decimal) 
PctEmplProfServ: porcentaje de personas de 16 años o más que están empleadas en servicios profesionales (numérico - decimal) 
PctOccupManu: porcentaje de personas de 16 años o más que están empleadas en la manufactura (numérico - decimal) ######## 
PctOccupMgmtProf: porcentaje de personas de 16 años o más que están empleadas en ocupaciones de gestión o profesionales (numérico - decimal) 
MalePctDivorce: porcentaje de hombres divorciados (numérico - decimal) 
MalePctNevMarr: porcentaje de hombres que nunca se han casado (numérico - decimal) 
FemalePctDiv: porcentaje de mujeres divorciadas (numérico - decimal) 
TotalPctDiv: porcentaje de población que está divorciada (numérico - decimal) 
PersPerFam: número medio de personas por familia (numérico - decimal) 
PctFam2Par: porcentaje de familias (con hijos) que son encabezadas por dos padres (numérico - decimal) 
PctKids2Par: porcentaje de niños en viviendas familiares con dos padres (numérico - decimal) 
PctYoungKids2Par: porcentaje de niños de 4 años o menos en hogares con dos padres (numérico - decimal) 
PctTeen2Par: porcentaje de niños de 12 a 17 años en hogares con dos padres (numérico - decimal) 
PctWorkMomYoungKids: porcentaje de madres de niños menores de 6 años en la fuerza laboral (numérico - decimal) 
PctWorkMom: porcentaje de madres de niños menores de 18 años en la fuerza laboral (numérico - decimal) 
NumIlleg: número de niños nacidos de padres que nunca se han casado (numérico - decimal) 
PctIlleg: porcentaje de niños nacidos de padres que nunca se han casado (numérico - decimal) 
NumImmig: número total de personas conocidas por ser nacidas en el extranjero (numérico - decimal) 
PctImmigRecent: porcentaje de _inmigrantes_ que emigraron en los últimos 3 años (numérico - decimal) 
PctImmigRec5: porcentaje de _inmigrantes_ que emigraron en los últimos 5 años (numérico - decimal) 
PctImmigRec8: porcentaje de _inmigrantes_ que emigraron en los últimos 8 años (numérico - decimal) 
PctImmigRec10: porcentaje de _inmigrantes_ que emigraron en los últimos 10 años (numérico - decimal) 
PctRecentImmig: porcentaje de _población_ que ha emigrado en los últimos 3 años (numérico - decimal) 
PctRecImmig5: porcentaje de _población_ que ha emigrado en los últimos 5 años (numérico - decimal) 
PctRecImmig8: porcentaje de _población_ que ha emigrado en los últimos 8 años (numérico - decimal) 
PctRecImmig10: porcentaje de _población_ que ha emigrado en los últimos 10 años (numérico - decimal) 
PctSpeakEnglOnly: porcentaje de personas que hablan solo inglés (numérico - decimal) 
PctNotSpeakEnglWell: porcentaje de personas que no hablan bien inglés (numérico - decimal) 
PctLargHouseFam: porcentaje de hogares familiares que son grandes (6 o más) (numérico - decimal) 
PctLargHouseOccup: porcentaje de todos los hogares ocupados que son grandes (6 o más personas) (numérico - decimal) 
PersPerOccupHous: personas promedio por hogar (numérico - decimal) 
PersPerOwnOccHous: personas promedio por hogar ocupado por el propietario (numérico - decimal) 
PersPerRentOccHous: personas promedio por hogar de alquiler (numérico - decimal) 
PctPersOwnOccup: porcentaje de personas en hogares ocupados por el propietario (numérico - decimal) 
PctPersDenseHous: porcentaje de personas en viviendas densas (más de 1 persona por habitación) (numérico - decimal) 
PctHousLess3BR: porcentaje de unidades de vivienda con menos de 3 dormitorios (numérico - decimal) 
MedNumBR: número mediano de dormitorios (numérico - decimal) 
HousVacant: número de viviendas vacantes (numérico - decimal) 
PctHousOccup: porcentaje de viviendas ocupadas (numérico - decimal) 
PctHousOwnOcc: porcentaje de hogares ocupados por el propietario (numérico - decimal) 
PctVacantBoarded: porcentaje de viviendas vacantes que están tapiadas (numérico - decimal) 
PctVacMore6Mos: porcentaje de viviendas vacantes que han estado vacantes más de 6 meses (numérico - decimal) 
MedYrHousBuilt: año mediano de construcción de unidades de vivienda (numérico - decimal) 
PctHousNoPhone: porcentaje de unidades de vivienda ocupadas sin teléfono (¡en 1990, esto era raro!) (numérico - decimal) 
PctWOFullPlumb: porcentaje de viviendas sin instalaciones de plomería completas (numérico - decimal) 
OwnOccLowQuart: viviendas ocupadas por el propietario - valor del cuartil inferior (numérico - decimal) 
OwnOccMedVal: viviendas ocupadas por el propietario - valor mediano (numérico - decimal) 
OwnOccHiQuart: viviendas ocupadas por el propietario - valor del cuartil superior (numérico - decimal) 
RentLowQ: viviendas de alquiler - alquiler del cuartil inferior (numérico - decimal) 
RentMedian: viviendas de alquiler - alquiler mediano (variable del censo H32B del archivo STF1A) (numérico - decimal) 
RentHighQ: viviendas de alquiler - alquiler del cuartil superior (numérico - decimal) 
MedRent: alquiler bruto mediano (variable del censo H43A del archivo STF3A - incluye servicios públicos) (numérico - decimal) 
MedRentPctHousInc: alquiler bruto mediano como porcentaje del ingreso del hogar (numérico - decimal) 
MedOwnCostPctInc: costo mediano de la propiedad como porcentaje del ingreso del hogar - para propietarios con hipoteca (numérico - decimal) 
MedOwnCostPctIncNoMtg: costo mediano de la propiedad como porcentaje del ingreso del hogar - para propietarios sin hipoteca (numérico - decimal) 
NumInShelters: número de personas en refugios para personas sin hogar (numérico - decimal) 
NumStreet: número de personas sin hogar contadas en la calle (numérico - decimal) 
PctForeignBorn: porcentaje de personas nacidas en el extranjero (numérico - decimal) 
PctBornSameState: porcentaje de personas nacidas en el mismo estado que actualmente viven (numérico - decimal) 
PctSameHouse85: porcentaje de personas que viven en la misma casa que en 1985 (5 años antes) (numérico - decimal) 
PctSameCity85: porcentaje de personas que viven en la misma ciudad que en 1985 (5 años antes) (numérico - decimal) 
PctSameState85: porcentaje de personas que viven en el mismo estado que en 1985 (5 años antes) (numérico - decimal) 
LemasSwornFT: número de agentes de policía juramentados a tiempo completo (numérico - decimal) 
LemasSwFTPerPop: agentes de policía juramentados a tiempo completo por cada 100 mil habitantes (numérico - decimal) 
LemasSwFTFieldOps: número de agentes de policía juramentados a tiempo completo asignados a funciones de operaciones de campo (como patrulla y respuesta a emergencias) (numérico - decimal) 
LemasSwFTFieldPerPop: agentes de policía juramentados a tiempo completo asignados a funciones de operaciones de campo (como patrulla y respuesta a emergencias) por cada 100 mil habitantes (numérico - decimal) 
LemasTotalReq: número total de solicitudes de ayuda de la policía (numérico - decimal) 
LemasTotReqPerPop: número total de solicitudes de ayuda de la policía por cada 100 mil habitantes (numérico - decimal) 
PolicReqPerOffic: número de solicitudes de ayuda policial por cada agente de policía (numérico - decimal) 
PolicPerPop: número de agentes de policía por cada 100 mil habitantes (numérico - decimal) 
RacialMatchCommPol: coincidencia racial entre la población y la comunidad policial (numérico - decimal) 
PctPolicWhite: porcentaje de oficiales de policía que son caucásicos (numérico - decimal) 
PctPolicBlack: porcentaje de oficiales de policía que son afroamericanos (numérico - decimal) 
PctPolicHisp: porcentaje de oficiales de policía que son hispanos (numérico - decimal) 
PctPolicAsian: porcentaje de oficiales de policía que son asiáticos (numérico - decimal) 
PctPolicMinor: porcentaje de oficiales de policía que son de una minoría racial (numérico - decimal) 
OfficAssgnDrugUnits: número de oficiales de policía asignados a unidades especiales de drogas (numérico - decimal) 
NumKindsDrugsSeiz: número de diferentes tipos de drogas incautadas (numérico - decimal) 
PolicAveOTWorked: horas de trabajo extra promedio para policías (numérico - decimal) 
LandArea: área de tierra en millas cuadradas (numérico - decimal) 
PopDens: densidad de población en personas por milla cuadrada (numérico - decimal) 
PctUsePubTrans: porcentaje de personas que usan el transporte público para ir al trabajo (numérico - decimal) 
PolicCars: número de coches de policía (numérico - decimal) 
PolicOperBudg: presupuesto operativo de la policía en dólares (numérico - decimal) 
LemasPctPolicOnPatr: porcentaje de fuerza policial asignada a patrulla (numérico - decimal) 
LemasGangUnitDeploy: número de unidades de policía asignadas a la unidad de pandillas (numérico - decimal) 
LemasPctOfficDrugUn: porcentaje de oficiales de policía asignados a unidades especiales de drogas (numérico - decimal) 
PolicBudgPerPop: presupuesto policial per cápita (numérico - decimal) 
ViolentCrimesPerPop: tasa de delitos violentos per cápita (predicción) (numérico - decimal)